         A           
         A           
  #######.#########  
  #######.........#  
  #######.#######.#  
  #######.#######.#  
  #######.#######.#  
  #####  B    ###..QQ
BC...##  C    ###.#  
  ##.##     QQ....#  
  ##...DE  F  ###.#  
  #####    G  ###.#  
  #########.#####.#  
DE..#######...###.#  
  #.#########.###.#  
FG..#########.....#  
  ###########.#####  
             Z       
             Z       
